NO ./path_to_the_north_texture.xpm
SO ./path_to_the_south_texture.xpm
EA ./path_to_the_east_texture.xpm
WE ./path_to_the_west_texture.xpm
C 255,0,0
F 0,0,255

1111111111111111111111111
1000100000000000000000001
1000100000000000000000001
1000100000000011100000001
1000111111111110000000001
1000000000000000000000001
1100000000000000000000011
101000000000000N000000001
1010000000000000000000001
1010000000000000000000001
1010000000000000000000001
1010000000000000000000011
1010000000000000000000001
1010000000000001111111001
1010000011110001000001001
1010000010000001001111001
1010000011110001000000001
1010000000010001111111111
1010000011110000000000001
1010000010000000000000001
1111111111111111111111111