NO ./path_to_the_north_texture.xpm
EA ./path_to_the_east_texture.xpm
WE ./path_to_the_west_texture.xpm
SO ./path_to_the_south_texture.xpm
C 99,148,255
F 218,255,255
11111111111111111111111111111111111111111111
10001000000000000000000000000000000000000001
10001000000000000000000011111111111111111111
1000100000000011100000001
1000111111111110000000001
1000000000000000000000001
1000000000000000000000001
1000000000000000000000001
1000000001000000000000001
1000000000100000000000001
10000000N0000000000000001
1000000000000001111111001
1111111111111111111111111
